+------------------------+
|---------|              |
|---------|  |---------+ |
|---------|  |           |
+---------+  |------+  + |
         @   |------|  | |
+---------+  |------|  | |
|       K |  +------|  | |
|  +------+    D    |  |X| 
|                   |  | |
|  +----------------+  | |
|                        |
+------------------------+