+-----------------------------------+--------+
|                                   |        |
+------------+ +-+---------------+  |  +-----+
             | | |                + |        |
+ +-------+  | | |  +   +-------+ | |  +---+ |
|         |  +-+ +  |           | | |      | |
| +-------+         |   +-------+ | +------+-+
|         |         |           | |          |
+-------+ +---------------------+ | +-+------+
|                   |             | | |      |
| +-----+ +-------+ | +-----------+-+ |      |
| |               | |                 | +--+ |
| |  + +----------+ | +---+-----------+    | |
| |  | |          | |     |                | |
| |  | |    + + + | | +---+ +--------------+ |
+-+  | |    | | | | |                      | |
|    | |    | | | | +--------------------+ | |
| +--+ |    | | | |                        | |
| |  + |    | | | +------------------------+ |
| |    |    | | |                            |
| +----+-+  | +-+---+----------------------+ |
|        |  |       |                      | |
+------+ |  +-------+ +------------------+ | |
|        |                               | | |
+--------+ +-----------------------------+ | |
|          |                               | |
|          +---+ +----------+--------------+ |
|          |                |              | |
|          | +--------------+ +----------+ | |
|          |                             | | |
| +--------+---------+-------------------+ | |
|                    |                   | | |
+--------------------+-------------------+X+-+
