+-----+---------+-----+--------+
      |         |     |        |
+--+  |   +--+--+  +  +----+   |
|     |      |     |           |
|   +-+-+    + +   +-----------+
|              |   |           |
+---+ +---+    |   +--------+  |
|   | |        |               |
|   + | +-+    +---------------+
|     | | +--+                 |
+-----+ | |  +-+-+   |         |
|       | |   +--+   |    +----+
| +-----+ |          |         |
| |       |   +---+--+    +    |
| | +-----+   |   |       |    |
| | |     |   |   |       |    |
| | +---+ |   |   +  +----+    |
| |     | |   |           |    |
| +--+  + |   +------+    +----|
|         |          |         X
+---------+----------+---------+